Tell me about robberies near the University last month	History_10_NonParametric	1.0	prep, LOCATION, tell, CALENDARX, INCIDENT_TYPE
tell me anything about murders in 1 mile from the Willis tower	History_10_NonParametric	1.0	prep, LOCATION, INCIDENT_TYPE, tell
show crimes in my district in August 2014	History_10_NonParametric	1.0	prep, LOCATION, tell, CALENDARX, INCIDENT_TYPE
list all reports of theft for last week	History_10_NonParametric	1.0	prep, report, tell, CALENDARX, INCIDENT_TYPE
can you report me about arsons committed in 3 miles around the art museum last month	History_10_NonParametric	1.0	report, LOCATION, tell, aux, CALENDARX, INCIDENT_TYPE
I need cases in the Willis tower	History_10_NonParametric	1.0	prep, report, LOCATION, det
show me the robbery statistics for the willis tower in july	History_10_NonParametric	1.0	prep, report, LOCATION, tell, det, CALENDARX, INCIDENT_TYPE
show me all emergency services calls for zip 19134 yesterday	History_10_NonParametric	1.0	prep, report, LOCATION, tell, CALENDARX, INCIDENT_TYPE
could you show me the robbery stats for the willis tower area	History_10_NonParametric	1.0	prep, report, LOCATION, tell, det, INCIDENT_TYPE
Tell me about robberies near the Willis tower in August	History_10_NonParametric	1.0	prep, LOCATION, tell, CALENDARX, INCIDENT_TYPE
show me murders near central district	History_10_NonParametric	1.0	prep, LOCATION, INCIDENT_TYPE, tell
history for location	History_10_NonParametric	1.0	prep, report, where
give me a report on crimes near the willis tower yesterday	History_10_NonParametric	1.0	prep, report, LOCATION, det, CALENDARX, INCIDENT_TYPE
please display the EMS call stats for yesterday	History_10_NonParametric	1.0	prep, report, tell, det, CALENDARX, INCIDENT_TYPE
give me information on the number of murders within a 5 mile radius of here for last week	History_10_NonParametric	1.0	prep, report, LOCATION, det, CALENDARX, INCIDENT_TYPE
Show me robberies near the Willis Tower	History_10_NonParametric	1.0	LOCATION, INCIDENT_TYPE, tell
I need last year cases	History_10_NonParametric	1.0	report, CALENDARX
Tell me about robberies near the University	History_10_NonParametric	1.0	prep, LOCATION, INCIDENT_TYPE, tell
show murders in calumet	History_10_NonParametric	1.0	prep, LOCATION, INCIDENT_TYPE, tell
show me murders in 3 miles from here	History_10_NonParametric	1.0	LOCATION, INCIDENT_TYPE, tell
show crimes near the bank	History_10_NonParametric	1.0	prep, LOCATION, tell, det, INCIDENT_TYPE
Tell me about robberies in the <abracadabra> last month	History_10_NonParametric	0.6	prep, LOCATION, tell, det, CALENDARX, INCIDENT_TYPE
show the murders committed last week in the willis tower	History_10_NonParametric	0.7	prep, LOCATION, tell, det, CALENDARX, INCIDENT_TYPE
Tell me about robberies near the University in September	History_10_NonParametric	1.0	prep, LOCATION, tell, CALENDARX, INCIDENT_TYPE
Tell me how many thefts there were in july for the city	Prediction_10_Parametric	0.5	prep, LOCATION, tell, det, CALENDARX
show murders in district 7	History_10_NonParametric	0.8	LOCATION, INCIDENT_TYPE, tell
have there been any fires near the willis tower in july?	History_10_NonParametric	0.7	prep, CALENDARX, LOCATION, det
provide the theft stats for yesterday in the entire city 	History_10_NonParametric	0.7	prep, report, LOCATION, det, CALENDARX, INCIDENT_TYPE
how many thefts were reported last week in chicago	History_10_NonParametric	0.6
show me last week murders	History_10_NonParametric	0.6	CALENDARX, INCIDENT_TYPE, tell
thefts within 3 blocks of the willis tower	History_10_NonParametric	0.6	prep, LOCATION, det
Show me homicides in the Old Town in August	History_10_NonParametric	0.7	prep, LOCATION, tell, det, CALENDARX, INCIDENT_TYPE
show me murders in September	History_10_NonParametric	0.6	prep, CALENDARX, INCIDENT_TYPE, tell
how many robberies occurred in the university last year 	History_10_NonParametric	0.8	prep, CALENDARX, LOCATION, det
show me all EMS calls for kensington in the past 48 hours	History_10_NonParametric	0.7	prep, report, LOCATION, tell, det, INCIDENT_TYPE
show all thefts for last week in the downtown area	History_10_NonParametric	0.5	prep, report, LOCATION, tell, det, CALENDARX
find all reported rapes in  the city yesterday	History_10_NonParametric	0.7	prep, CALENDARX, LOCATION, det
inform me of the embezzlements in the bank of america	Prediction_10_Parametric	0.3	prep, LOCATION, tell, det, INCIDENT_TYPE
show me robberies nearby	History_10_NonParametric	0.7	INCIDENT_TYPE, tell
let me see the arsons that occurred around the willis tower in 2014	History_10_NonParametric	0.9	prep, LOCATION, tell, det
all fires in the past 24 hours	History_10_NonParametric	0.4	prep, LOCATION, det
What is the history for that location	History_10_NonParametric	0.5	prep, report, tell, det, aux
show me murders in 1 mile from 1 district	History_10_NonParametric	0.8	LOCATION, INCIDENT_TYPE, tell
inform me of the embezzlements in April in the bank of America	Prediction_10_Parametric	0.3	prep, LOCATION, tell, det, CALENDARX
last week's murder statistics for all of chicago 	History_10_NonParametric	1.0	prep, report, CALENDARX, INCIDENT_TYPE
robberies in the willis tower in 2010	History_10_NonParametric	0.8	prep, LOCATION, tell, det
what are the robbery stats for the willis tower area for the past year	History_10_NonParametric	0.7	prep, report, LOCATION, tell, det, CALENDARX, INCIDENT_TYPE
Give me the number of thefts for july within 3 blocks of the willis tower	History_10_NonParametric	0.8	prep, report, LOCATION, tell, det, CALENDARX, INCIDENT_TYPE
Tell me about robberies in 2 kilometers from the Willis tower in August	History_10_NonParametric	0.8	prep, LOCATION, tell, CALENDARX, INCIDENT_TYPE
how many fires were there in April	Prediction_10_Parametric	0.5	prep, CALENDARX
give me the willis tower crime stats for july 	History_10_NonParametric	1.0	prep, LOCATION, tell, det, CALENDARX
Tell me about robberies in 100 yards from here in August	History_10_NonParametric	0.7	prep, LOCATION, tell, CALENDARX, INCIDENT_TYPE
Tell me about robberies last month	History_10_NonParametric	0.5	prep, CALENDARX, INCIDENT_TYPE, tell
incidents of arson in the past 24 hours	Prediction_10_Parametric	0.5	prep, LOCATION, tell, det, INCIDENT_TYPE
show me robberies history	History_10_NonParametric	0.8	INCIDENT_TYPE, tell
can you tell me anything about murders in the university in july 	History_10_NonParametric	0.7	prep, LOCATION, tell, CALENDARX, INCIDENT_TYPE
show incidents in my district in August 2015	History_10_NonParametric	0.8	prep, LOCATION, tell, CALENDARX, INCIDENT_TYPE
i need the last month cases	History_10_NonParametric	1.0	report, CALENDARX
display all reported crimes for the immediate area yesterday	History_10_NonParametric	0.7	prep, CALENDARX, LOCATION, det
tell me anything about last month murders in 1 mile from the willlis tower	History_10_NonParametric	0.8	prep, LOCATION, tell, CALENDARX, INCIDENT_TYPE
Tell me about robberies near the <abracadabra> last month	History_10_NonParametric	0.8	prep, LOCATION, tell, CALENDARX, INCIDENT_TYPE
Show me robberies in September	History_10_NonParametric	0.7	prep, CALENDARX, INCIDENT_TYPE, tell
how many thefts occurred in july near the Willis Tower	History_10_NonParametric	1.0	prep, CALENDARX, LOCATION, det
show me crime stats for this area for last week	History_10_NonParametric	1.0	prep, report, tell, det, CALENDARX, INCIDENT_TYPE
Tell me about robberies in 2 miles last month	History_10_NonParametric	0.5	prep, LOCATION, tell, CALENDARX, INCIDENT_TYPE
all 2014 murders within a 500 meter radius of the willis tower 	History_10_NonParametric	0.6	prep, LOCATION, tell, det, INCIDENT_TYPE
say anything about murders committed last week in 1 mile around chatham	History_10_NonParametric	0.8	prep, LOCATION, tell, CALENDARX, INCIDENT_TYPE
tell me about last week murders near willis tower	History_10_NonParametric	1.0	prep, LOCATION, tell, CALENDARX, INCIDENT_TYPE
Show me robberies near the Willis Tower in September	History_10_NonParametric	1.0	prep, LOCATION, tell, det, CALENDARX, INCIDENT_TYPE
update me on the number of murders in the willis tower area for 2014	History_10_NonParametric	1.0	prep, report, LOCATION, tell, det, INCIDENT_TYPE
How many thefts were there in july around the willis tower	History_10_NonParametric	0.9	prep, CALENDARX, LOCATION, det
bring up all thefts with a mile of the willis tower on june 10	History_10_NonParametric	0.9	prep, CALENDARX, LOCATION, det
How many thefts happened in the University in September?	History_10_NonParametric	0.3	prep, CALENDARX, LOCATION, det
show me murders near calumet district committed last week	History_10_NonParametric	0.8	prep, LOCATION, tell, CALENDARX, INCIDENT_TYPE
thefts in july in the area of the willis tower	History_10_NonParametric	0.7	prep, LOCATION, tell, det, CALENDARX, where
Tell me the number of 911 calls made last week	History_10_NonParametric	0.8	prep, report, tell, det, CALENDARX
list all robberies in the city in the past 2 days	History_10_NonParametric	0.5	prep, report, LOCATION, tell, det, INCIDENT_TYPE
Tell me about robberies nearby in August	History_10_NonParametric	0.6	prep, LOCATION, tell, CALENDARX, INCIDENT_TYPE
show me the nearest last month robberies	History_10_NonParametric	0.7	CALENDARX, INCIDENT_TYPE, tell, det
july murder stats for the sears tower area	History_10_NonParametric	0.7	prep, report, LOCATION, tell, det
give me robbery stats for within 10 minutes of the willis tower in july	History_10_NonParametric	1.0	prep, report, LOCATION, tell, det, CALENDARX, INCIDENT_TYPE
thefts in july within 5 minutes of the willis tower	History_10_NonParametric	0.9	prep, LOCATION, tell, det, CALENDARX
Tell me about robberies in 2 miles from the <abracadabra> last month	History_10_NonParametric	0.6	prep, LOCATION, tell, CALENDARX, INCIDENT_TYPE
what about murders stats	History_10_NonParametric	0.8	prep, LOCATION, INCIDENT_TYPE, tell
july thefts near the willis tower 	History_10_NonParametric	0.9	prep, LOCATION, tell, det, INCIDENT_TYPE
list all thefts last week for the willis tower area	History_10_NonParametric	1.0	prep, report, LOCATION, tell, det, CALENDARX
can you tell me anything about murder predictions on the 4 of may from 5 pm till 6 pm in the Addams park 	Prediction_10_Parametric	1.0	prep, risk, LOCATION, tell, det, CALENDARX, INCIDENT_TYPE
Where it is the most risky today	Prediction_10_Parametric	1.0	risk, CALENDARX, where, det
In what location is the risk of robbery battery	Prediction_10_Parametric	1.0	prep, risk, det, aux, where, INCIDENT_TYPE
In what area it is the most dangerous meaning murders	Prediction_10_Parametric	1.0	prep, risk, det, where, INCIDENT_TYPE
what is the nearest dangerous area	Prediction_10_Parametric	1.0	risk, where, det
tell me about murder predictions in evening	Prediction_10_Parametric	1.0	prep, risk, tell, CALENDARX, INCIDENT_TYPE
Show me the robberies risk in 5 hours from now	Prediction_10_Parametric	1.0	risk, tell, det, CALENDARX, INCIDENT_TYPE
in what area of the central district it is the most dangerous during the 1st watch	Prediction_10_Parametric	1.0	prep, risk, LOCATION, det, where, SHIFT_NUMBER
What areas are risky now	Prediction_10_Parametric	1.0	risk, CALENDARX, where, aux
In what calumet district area the murder risk is the highest	Prediction_10_Parametric	1.0	risk, LOCATION, det, aux, where, INCIDENT_TYPE
In what location is the risk of robbery highest	Prediction_10_Parametric	1.0	prep, risk, det, aux, where, INCIDENT_TYPE
What is the risk of a kidnapping today	Prediction_10_Parametric	1.0	prep, risk, tell, det, aux, CALENDARX, INCIDENT_TYPE
What is the risk of a robbery happening today	Prediction_10_Parametric	1.0	prep, risk, det, aux, CALENDARX, INCIDENT_TYPE
show the hotspots for today	Prediction_10_Parametric	1.0	prep, risk, tell, det, CALENDARX
In what 20 district area it is the most risky with murders during the 2nd watch	Prediction_10_Parametric	1.0	prep, risk, LOCATION, det, where, INCIDENT_TYPE, SHIFT_NUMBER
tell me about murder estimations on the 4 of may in the morning in 1 mile from the bank	Prediction_10_Parametric	1.0	prep, risk, LOCATION, tell, det, CALENDARX, INCIDENT_TYPE
What is the robbery prediction for the Old Town for tomorrow morning	Prediction_10_Parametric	1.0	prep, risk, LOCATION, det, INCIDENT_TYPE, tell, aux, CALENDARX
What is the risk of a murder today	Prediction_10_Parametric	1.0	prep, risk, tell, det, aux, CALENDARX, INCIDENT_TYPE
What's the likelihood of a robbery occurring today	Prediction_10_Parametric	1.0	prep, risk, det, aux, CALENDARX, INCIDENT_TYPE
where are the hotspots during 1 shift	Prediction_10_Parametric	1.0	prep, risk, det, aux, where, SHIFT_NUMBER
what are the hotspots	Prediction_10_Parametric	1.0	risk, tell, det
show murders on the 4 of may	Prediction_10_Parametric	0.6	prep, tell, det, CALENDARX, INCIDENT_TYPE
what area is today the most dangerous about murders in the tenth district during the first watch	Prediction_10_Parametric	1.0	prep, risk, LOCATION, det, INCIDENT_TYPE, tell, aux, where, SHIFT_NUMBER
What is the risk of a rape today?	Prediction_10_Parametric	1.0	prep, risk, tell, det, aux, CALENDARX, INCIDENT_TYPE
can you tell me the morning predictions	Prediction_10_Parametric	0.6	risk, INCIDENT_TYPE, tell, det
What area is today during the second watch the most risky in terms of murders	Prediction_10_Parametric	1.0	prep, risk, det, INCIDENT_TYPE, aux, where, CALENDARX, SHIFT_NUMBER
What is the risk of a homicide today	Prediction_10_Parametric	1.0	prep, risk, tell, det, aux, CALENDARX, INCIDENT_TYPE
Do you think there will be any robberies today?	Prediction_10_Parametric	0.7	CALENDARX
What is robbery risk near the Willis tower?	History_10_NonParametric	0.4	prep, LOCATION, tell, det, aux, INCIDENT_TYPE
What area is the most risky tomorrow during the second watch	Prediction_10_Parametric	1.0	prep, risk, det, aux, CALENDARX, where, SHIFT_NUMBER
i meant predictions for the 4 of may	Prediction_10_Parametric	0.9	prep, CALENDARX, tell, det
show me the forecast for robberies in Beverly on the 1 of december	History_10_NonParametric	0.5	prep, LOCATION, tell, det, CALENDARX, INCIDENT_TYPE
Closest focus areas	Prediction_10_Parametric	0.3
what are the hotspots in 1 mile from the willis tower	Prediction_10_Parametric	0.4	prep, risk, LOCATION, tell, det
where it is risky today	Prediction_10_Parametric	0.7	risk, CALENDARX, where, aux
show me tomorrow murders hotspots	History_10_NonParametric	0.7	prep, INCIDENT_TYPE, tell
where in central district today the robberies risks are the highest	Prediction_10_Parametric	0.9	prep, risk, LOCATION, det, where
Tell me the chance of a robbery today?	Prediction_10_Parametric	0.8	prep, risk, tell, det, CALENDARX, INCIDENT_TYPE
Closest hotspot	Prediction_10_Parametric	0.9
Focus areas	Prediction_10_Parametric	0.3
in which area the robberies risks are high during the first shift today	Prediction_10_Parametric	0.8	prep, CALENDARX, where, det
show the hotspots	Prediction_10_Parametric	0.9	risk, tell, det
show predictions about murders on the 4 of may	Prediction_10_Parametric	0.8	prep, tell, det, CALENDARX, INCIDENT_TYPE
Where the risk is the highest today during the 3 watch	Prediction_10_Parametric	1.0	prep, risk, det, aux, CALENDARX, where
predict murders in willis tower	History_10_NonParametric	1.0	prep, LOCATION, INCIDENT_TYPE, tell
what is the most risky area nearby	Prediction_10_Parametric	1.0	prep, risk, tell, det, aux, INCIDENT_TYPE
In what location is robberies risk highest?	Prediction_10_Parametric	1.0	where, aux
show me the forecast about murders expected to be committed in North Park	NO_INTENT	0.5	prep, LOCATION, tell, det, INCIDENT_TYPE
What is the risk of a burglary today	Prediction_10_Parametric	1.0	prep, risk, tell, det, aux, CALENDARX, INCIDENT_TYPE
Which area is the most risky today?	Prediction_10_Parametric	1.0	risk, CALENDARX, det, aux
What is the crime prediction for tomorrow morning?	Prediction_10_Parametric	1.0	prep, risk, tell, det, aux, CALENDARX, INCIDENT_TYPE
in what area it is the most risky today	Prediction_10_Parametric	1.0	risk, CALENDARX, where, det
In what area of the Central district today during the 2nd watch it is the most risky	Prediction_10_Parametric	1.0	prep, risk, LOCATION, det, aux, where, CALENDARX, SHIFT_NUMBER
Where the risk of a murder is the highest	Prediction_10_Parametric	1.0	prep, risk, det, aux, where, INCIDENT_TYPE
What location carries the highest risk of theft?	Prediction_10_Parametric	1.0	prep, tell, det, where, INCIDENT_TYPE
which central district area carries high robberies risks today	History_10_NonParametric	0.5	CALENDARX
Show me the robberies risk in 5 hours	Prediction_10_Parametric	0.9	risk, tell, det, CALENDARX, INCIDENT_TYPE
What is the risk of a robbery today	Prediction_10_Parametric	1.0	prep, risk, tell, det, aux, CALENDARX, INCIDENT_TYPE
show me the hotspots in this district	Prediction_10_Parametric	0.7	prep, LOCATION, tell, det, INCIDENT_TYPE
what fifth district area today is dangerous in terms of crimes during the second watch	Prediction_10_Parametric	0.8	prep, LOCATION, det, INCIDENT_TYPE, tell, aux, where, CALENDARX, SHIFT_NUMBER
predict me robberies hotspots in 5 hours	Prediction_10_Parametric	0.8	risk, CALENDARX, INCIDENT_TYPE, tell
Show me the robberies risk for tomorrow from 3 to 6 pm	Prediction_10_Parametric	0.8	prep, risk, LOCATION, tell, det, CALENDARX, INCIDENT_TYPE
predict tomorrow thefts in 2 miles from here	History_10_NonParametric	0.4	prep, LOCATION
i need predictions in 2 miles from the willis tower	History_10_NonParametric	0.7	prep, report, LOCATION, tell
forecast murders near university	History_10_NonParametric	0.7	LOCATION, INCIDENT_TYPE, tell
What is robberies prediction for the Old Town for tomorrow morning	Prediction_10_Parametric	1.0	prep, risk, LOCATION, det, INCIDENT_TYPE, tell, aux, CALENDARX
In what area it is the most dangerous during the 3rd watch	Prediction_10_Parametric	1.0	prep, risk, det, aux, where, SHIFT_NUMBER
show me the predictions of arsons in Chatham	Prediction_10_Parametric	0.7	prep, risk, tell, det, CALENDARX, INCIDENT_TYPE
How likely is a robbery today? 	Prediction_10_Parametric	0.8	CALENDARX, INCIDENT_TYPE, det, aux
show me the forecast about murders expected in North Park	History_10_NonParametric	0.7	prep, tell, det, CALENDARX, INCIDENT_TYPE
Show me the robberies risk in 5 hours from <abracadabra>	Prediction_10_Parametric	1.0	risk, tell, det, CALENDARX, INCIDENT_TYPE
predict me robberies in 5 hours	Prediction_10_Parametric	0.7	LOCATION, INCIDENT_TYPE, tell
what is the most risky area	Prediction_10_Parametric	1.0	risk, tell, det, aux
What area is today the most risky	Prediction_10_Parametric	1.0	risk, where, det, aux
Where the risk is the highest during the 2nd watch today	Prediction_10_Parametric	1.0	prep, risk, det, aux, CALENDARX, where, SHIFT_NUMBER
which area carries the highest risk tomorrow during the 3rd shift	Prediction_10_Parametric	1.0	prep, risk, tell, det, CALENDARX
What 1st district area today is the most risky during the 2nd shift	Prediction_10_Parametric	1.0	prep, risk, LOCATION, det, tell, aux, where, CALENDARX, SHIFT_NUMBER
Show me the robberies risk for January 5 from 2 to 3 pm.	Prediction_10_Parametric	0.8	prep, risk, LOCATION, tell, det, CALENDARX, INCIDENT_TYPE
Show me the robberies risk for today.	Prediction_10_Parametric	0.5	prep, risk, tell, det, CALENDARX, INCIDENT_TYPE
where today the robberies risk is the highest in central district	Prediction_10_Parametric	1.0	prep, risk, LOCATION, det, aux, where, INCIDENT_TYPE
Where the risk during the third watch is the biggest	Prediction_10_Parametric	0.6	prep, risk, det, aux, where
show me tomorrow morning hotspots	Prediction_10_Parametric	0.6	CALENDARX, tell
now give me the forecast 	Prediction_10_Parametric	0.6	INCIDENT_TYPE, tell, det
where today the robberies risk is high	Prediction_10_Parametric	1.0	risk, det, aux, where, INCIDENT_TYPE
What's the robbery risk for today?	Prediction_10_Parametric	0.9	prep, risk, tell, det, CALENDARX, INCIDENT_TYPE
In what first district area the murders risk is the highest	Prediction_10_Parametric	1.0	risk, LOCATION, det, aux, where, INCIDENT_TYPE
Which area is the most risky of theft today?	Prediction_10_Parametric	1.0	prep, risk, det, aux, CALENDARX, INCIDENT_TYPE
In what location is the risk of robbery highest	Prediction_10_Parametric	1.0	prep, risk, det, aux, where, INCIDENT_TYPE
What is the risk of an assault today	Prediction_10_Parametric	1.0	prep, risk, tell, det, aux, CALENDARX, INCIDENT_TYPE
where is it dangerous	Prediction_10_Parametric	0.5	tell, aux
can you tell me the morning arson estimate	Prediction_10_Parametric	0.5	tell, det
Where in the Central district it is dangerous today	Prediction_10_Parametric	0.8	prep, risk, LOCATION, det, aux, CALENDARX, where
What is the risk of arson today?	Prediction_10_Parametric	1.0	prep, risk, tell, det, aux, CALENDARX, INCIDENT_TYPE
what area in 5th district is the most risky today	Prediction_10_Parametric	1.0	prep, risk, LOCATION, det, tell, aux, where, CALENDARX
predict me robberies hotspots during 2 shift	Prediction_10_Parametric	0.7	tell
show me the morning predictions of arsons in Chatham	Prediction_10_Parametric	0.7	prep, tell, det, CALENDARX, INCIDENT_TYPE
What area during the 3 watch is the most dangerous	Prediction_10_Parametric	1.0	prep, risk, tell, det, aux, where
Where it is the most dangerous today during the 2nd watch	Prediction_10_Parametric	1.0	prep, risk, det, aux, CALENDARX, where, SHIFT_NUMBER
What's the possibility of a robbery today?	Prediction_10_Parametric	0.9	prep, risk, tell, det, CALENDARX, INCIDENT_TYPE
which central district area is during the third watch risky about murders today	Prediction_10_Parametric	0.8	prep, LOCATION, det, INCIDENT_TYPE, tell, aux, where, CALENDARX
In what area during the 2nd watch the robberies risk is the biggest	Prediction_10_Parametric	1.0	prep, risk, det, aux, where, INCIDENT_TYPE, SHIFT_NUMBER
What is the risk of a robbery occurring today	Prediction_10_Parametric	1.0	prep, risk, det, aux, CALENDARX, INCIDENT_TYPE
in which calumet district area today the robberies risk is high	Prediction_10_Parametric	0.8	prep, risk, LOCATION, det, aux, where, INCIDENT_TYPE
In what district it is the most risky	Prediction_10_Parametric	1.0	risk, where, det, aux
show me the hotspots in 200 yards from here	Prediction_10_Parametric	0.7	prep, LOCATION, tell, det, INCIDENT_TYPE
What district has the greatest risk	Prediction_10_Parametric	0.9	risk, tell, det, aux, INCIDENT_TYPE
Show me the robberies risk from 6 to 9 pm.	Prediction_10_Parametric	0.8	risk, LOCATION, tell, det, CALENDARX, INCIDENT_TYPE
show me tomorrow murder predictions in 1 mile from the theatre from 7 to 10 pm	Prediction_10_Parametric	0.8	prep, risk, LOCATION, tell, CALENDARX, INCIDENT_TYPE
what is the hotspot in the proximity	Prediction_10_Parametric	0.7	prep, risk, LOCATION, tell, det, aux
Show me the robberies risk from 6 to 9 pm.	Prediction_10_Parametric	0.8	risk, LOCATION, tell, det, CALENDARX, INCIDENT_TYPE
what areas are risky	Prediction_10_Parametric	0.9	risk, where, aux
Show me the robberies risk for the morning	Prediction_10_Parametric	0.6	prep, risk, tell, det, CALENDARX, INCIDENT_TYPE
What are the chances of a robbery today?	Prediction_10_Parametric	0.8	prep, risk, det, aux, CALENDARX, where, INCIDENT_TYPE
Show focus areas	History_10_NonParametric	0.7	tell
show me robberies prediction	Prediction_10_Parametric	0.6	risk, INCIDENT_TYPE, tell
which area of the eleventh district today is the most dangerous	Prediction_10_Parametric	1.0	prep, risk, LOCATION, det, aux, CALENDARX
show me hotspots with murders for the 4 of may	Prediction_10_Parametric	0.5	prep, tell, det, CALENDARX, INCIDENT_TYPE
closest focus calls	History_10_NonParametric	0.3
Do you predict any robberies today? 	Prediction_10_Parametric	0.7	CALENDARX
in what area of the central district the risk of murders is the highest tomorrow during the 1st watch	Prediction_10_Parametric	1.0	prep, risk, LOCATION, det, INCIDENT_TYPE, aux, where, CALENDARX, SHIFT_NUMBER
in what area the robberies risks are the highest in central district	Prediction_10_Parametric	0.8	prep, risk, LOCATION, det, where, INCIDENT_TYPE
in what district it is risky today	Prediction_10_Parametric	1.0	risk, CALENDARX, where, aux
predict me murders in the university tomorrow morning	History_10_NonParametric	0.5	prep, LOCATION, tell, det, CALENDARX, INCIDENT_TYPE
i needed arson predictions	Prediction_10_Parametric	0.8
in what area tomorrow the robberies risk will be the highest in calumet district	Prediction_10_Parametric	0.7	prep, risk, LOCATION, det, where, INCIDENT_TYPE
give me the forecast for robberies in 100 yards from the west side for today's morning	Prediction_10_Parametric	0.6	prep, LOCATION, tell, det, CALENDARX, INCIDENT_TYPE
can you give me the robberies forecast	History_10_NonParametric	0.6	INCIDENT_TYPE, tell, det
inform me about hotspots on 5 of september	Prediction_10_Parametric	0.7	prep, CALENDARX, INCIDENT_TYPE, tell
Where the risk is the highest	Prediction_10_Parametric	0.9	risk, where, det, aux
show me robberies prediction for 5 hours	Prediction_10_Parametric	0.6	risk, prep, INCIDENT_TYPE, tell
What is robbery risk near the Willis tower tomorrow?	Prediction_10_Parametric	0.3	prep, risk, LOCATION, det, INCIDENT_TYPE, tell, aux, CALENDARX
where is it dangerous now	Prediction_10_Parametric	0.8	tell, aux
What area in the 1st district carries the biggest risk today during the 2nd shift	Prediction_10_Parametric	1.0	prep, risk, LOCATION, det, INCIDENT_TYPE, tell, where, CALENDARX, SHIFT_NUMBER
what area tomorrow during the 2 shift has the biggest risk of murders	Prediction_10_Parametric	0.9	prep, tell, det, CALENDARX, where, INCIDENT_TYPE
Which area carries the highest risk of murders?	Prediction_10_Parametric	0.9	prep, INCIDENT_TYPE, det
i need predictions not on the 4 of may but on the 5 of may	Prediction_10_Parametric	0.8	prep, CALENDARX, tell, det
in which area tomorrow during the first watch the risk of murders will be the highest	Prediction_10_Parametric	0.7	prep, risk, det, INCIDENT_TYPE, SHIFT_NUMBER
tell me the estimate of murders tomorrow from 9 to 10 pm	NO_INTENT	0.3	prep, LOCATION, tell, det, CALENDARX, INCIDENT_TYPE
predict me tomorrow morning hotspots	Prediction_10_Parametric	0.9	CALENDARX, tell
show hotspots in my district for 1 shift	History_10_NonParametric	0.6	prep, LOCATION, INCIDENT_TYPE, tell
What Central district area carries during the first watch the biggest risk of murders	Prediction_10_Parametric	0.8	prep, LOCATION, tell, det, INCIDENT_TYPE, SHIFT_NUMBER
Show focus calls	History_10_NonParametric	0.8	tell
show me hotspots in the neighborhood	Prediction_10_Parametric	0.7	prep, LOCATION, tell, det, INCIDENT_TYPE
What location carries the highest risk of murder?	Prediction_10_Parametric	1.0	prep, tell, det, where, INCIDENT_TYPE
where are focus calls	Prediction_10_Parametric	0.5	where, aux
Focus calls	History_10_NonParametric	0.3
Where it is the most risky today concerning murders during the 2 watch	Prediction_10_Parametric	1.0	prep, risk, det, aux, CALENDARX, where, INCIDENT_TYPE
In what area of the 5 district it is the most dangerous concerning murders during the 2nd watch	Prediction_10_Parametric	1.0	prep, risk, LOCATION, det, INCIDENT_TYPE, aux, where, SHIFT_NUMBER
What area of the Central district carries tomorrow the biggest risk of murders	Prediction_10_Parametric	0.8	prep, LOCATION, tell, det, where, INCIDENT_TYPE
what area in fourth district is today more risky speaking about murders during the first watch	Prediction_10_Parametric	0.7	prep, LOCATION, det, INCIDENT_TYPE, tell, aux, where, SHIFT_NUMBER
What area carries the most murder risks today	Prediction_10_Parametric	1.0	prep, tell, det, CALENDARX, where
Show hotspots in my shift	Prediction_10_Parametric	0.7	prep, LOCATION, INCIDENT_TYPE, tell
forecast tomorrow morning murders nearby	Prediction_10_Parametric	0.7	CALENDARX, tell
tell me about tomorrow morning arsons estimation	History_10_NonParametric	0.6	prep, CALENDARX, tell
In what location it is the most dangerous today	Prediction_10_Parametric	1.0	risk, det, aux, CALENDARX, where
in what area during the second watch it is more risky with crimes today	Prediction_10_Parametric	0.9	prep, det, aux, CALENDARX, where, INCIDENT_TYPE, SHIFT_NUMBER
what area in 5th district is the most risky during the 2nd watch	Prediction_10_Parametric	1.0	prep, risk, LOCATION, det, tell, aux, where, SHIFT_NUMBER
what area today has big robberies risks in third district	Prediction_10_Parametric	0.7	prep, LOCATION, tell, CALENDARX, where
In what area during the 2nd watch robberies risk is the biggest	Prediction_10_Parametric	1.0	prep, risk, det, aux, where, INCIDENT_TYPE, SHIFT_NUMBER
In what area during the 2nd watch today the risk is the highest	Prediction_10_Parametric	1.0	prep, risk, det, aux, CALENDARX, where, SHIFT_NUMBER
what area carries the biggest robberies risk today during the 2 watch	Prediction_10_Parametric	1.0	prep, tell, det, CALENDARX, where
show the most risky district in 3 miles from here	Prediction_10_Parametric	0.5	prep, risk, LOCATION, tell, det
Show me the robberies risk near the Willis Tower	History_10_NonParametric	0.5	prep, LOCATION, tell, det, INCIDENT_TYPE
What is the risk of a theft today	Prediction_10_Parametric	1.0	prep, risk, tell, det, aux, CALENDARX, INCIDENT_TYPE
show me murders hotspots from 5 to 9	Prediction_10_Parametric	0.4	LOCATION, INCIDENT_TYPE, tell
Where are focus areas	Prediction_10_Parametric	0.6	where, aux
what area today is the most dangerous concerning crimes during the third watch	Prediction_10_Parametric	1.0	prep, risk, det, INCIDENT_TYPE, tell, aux, where, CALENDARX, SHIFT_NUMBER
In what area of the first district today it is the most risky meaning murders	Prediction_10_Parametric	1.0	prep, risk, LOCATION, det, aux, where, INCIDENT_TYPE
Show me the robberies risk for tomorrow morning	Prediction_10_Parametric	0.5	prep, risk, tell, det, CALENDARX, INCIDENT_TYPE
Do you think there will be a robbery today?	Prediction_10_Parametric	0.8	prep, CALENDARX, INCIDENT_TYPE, det
predict me robberies in 5 hours from now	Prediction_10_Parametric	0.9	prep, CALENDARX, INCIDENT_TYPE, tell
In which area the risk of murders during the 2nd watch is the highest today	Prediction_10_Parametric	1.0	prep, risk, det, aux, CALENDARX, where, INCIDENT_TYPE
give me the tomorrow morning estimate of crimes expected in 1 mile from the navy pier 	Prediction_10_Parametric	0.5	prep, LOCATION, tell, det, CALENDARX, INCIDENT_TYPE
In what area during the 1st watch it is the most risky with murders	Prediction_10_Parametric	1.0	prep, risk, det, aux, where, INCIDENT_TYPE, SHIFT_NUMBER
anything about address of the car owner	NO_INTENT	1.0	prep, tell, not_needed, det, where
show me address of the car owner	NO_INTENT	1.0	prep, tell, not_needed, det, where
What address is the vehicle regsitered at	NO_INTENT	1.0	where, det, not_needed, aux
What's the address of the vehicle owner	NO_INTENT	1.0	prep, where, det, not_needed
Where does the vehicle owner reside	NO_INTENT	1.0	where, det, not_needed, aux
Tell where the vehicle owner's home is located? 	NO_INTENT	0.6	tell, det, not_needed
Where can I find the owner of the car? 	NO_INTENT	0.7	prep, det, not_needed
Is there an address on the vehicle owner? 	NO_INTENT	1.0	prep, det, not_needed, aux
Please get me the address of the vehicle owner.	NO_INTENT	1.0	prep, tell, not_needed, det, where
What is the address where the vehicle is registered?	NO_INTENT	0.5	prep, risk, tell, not_needed, det, aux
What address is on the vehicle registration?	NO_INTENT	0.6	prep, not_needed, det, aux, where
What's the car owner's address? 	NO_INTENT	1.0	tell, det, not_needed
contacts of the car owner	NO_INTENT	1.0	prep, tell, det, not_needed
how do we contact the owner of case 12 car	NO_INTENT	0.8	prep, report, det, not_needed
What is the vehicle owner's address/phone number?	NO_INTENT	0.9	tell, det, not_needed, aux
Can I get contact information for the vehicle owner? 	NO_INTENT	0.6	prep, det, not_needed
How can we get in touch with the car owner? 	NO_INTENT	0.9	prep, det, not_needed
Get me the contact information for the vehicle owner. 	NO_INTENT	0.7	prep, report, tell, not_needed, det, INCIDENT_TYPE
I want to contact the car owner. 	NO_INTENT	1.0	prep, report, tell, not_needed, det
Find out how I can reach the owner of the car. 	NO_INTENT	0.8	prep, det, not_needed
Please display contact info for the vehicle owner.	NO_INTENT	0.7	prep, det, not_needed
How can I talk to the owner?	NO_INTENT	0.8	prep, INCIDENT_TYPE, det, not_needed
I need the details on how to contact the vehicle owner.	NO_INTENT	0.6	tell, det, not_needed
Where can I reach the owner of the car?	NO_INTENT	0.7	prep, det, not_needed
I'd like to contact whoever owns the car.	NO_INTENT	1.0	det, not_needed
Find me contact details for the vehcle owner 	History_10_NonParametric	0.3	prep, report, tell, det
How do we get in touch with the person to whom the veichle is registered?	NO_INTENT	0.8	prep, det, not_needed
who owns the car	NO_INTENT	1.0	det, not_needed
to whom is the case 12 car registered	NO_INTENT	1.0	report, det, not_needed, aux
Who is the car owner	NO_INTENT	1.0	det, not_needed, aux
Who is in possession of the car	NO_INTENT	1.0	prep, det, not_needed, aux
Who owns the car	NO_INTENT	1.0	det, not_needed
Whose car is this	NO_INTENT	1.0	det, not_needed, aux
What about the car owner?	NO_INTENT	1.0	prep, tell, det, not_needed
What do we know about the car owner? 	NO_INTENT	1.0	prep, det, not_needed
Whose vehicle is it?	NO_INTENT	0.6	not_needed
To whom is the vehicle registered?	NO_INTENT	1.0	det, not_needed, aux
What's the name on the vehicle registration?	NO_INTENT	0.3	prep, risk, tell, not_needed, det
Do we have an owner for that vehicle? 	NO_INTENT	0.6	not_needed
Whose name is the car in? 	NO_INTENT	0.7	det, not_needed, aux
Who is the car registered to?	NO_INTENT	1.0	det, not_needed, aux
Who's on the registration? 	Prediction_10_Parametric	0.4	prep, tell, det
Who does the car belong to?	NO_INTENT	1.0	det, not_needed
Who is the vehicle owner	NO_INTENT	1.0	det, not_needed, aux
how can i call the car owner	NO_INTENT	1.0	prep, det, not_needed
i want to call the car owner	NO_INTENT	1.0	prep, report, tell, not_needed, det
What's the vehicle owner's telephone number?	NO_INTENT	0.5	tell, det, not_needed
How can I get in contact/touch with the vehicle owner?	NO_INTENT	0.8	prep, det, not_needed
What's the number for the car owner? 	NO_INTENT	0.8	prep, report, tell, not_needed, det
At what number can we reach the car owner? 	NO_INTENT	0.8	prep, det, not_needed
I'd like to call the vehicle owner.	NO_INTENT	1.0	det, not_needed
Find me the car owner's number, please. 	NO_INTENT	0.8	tell, det, not_needed
who investigated case 12	NO_INTENT	0.6	not_needed
who is case 12 investigating officer	NO_INTENT	0.6	not_needed, aux
Who investigated the case	NO_INTENT	0.7	det, not_needed
Who handles incident 12	NO_INTENT	0.6	not_needed
Which officer handled the case	History_10_NonParametric	0.6	prep, det
Can I see case 12's detective?	History_10_NonParametric	0.7
Who is on case 12? 	NO_INTENT	0.6	not_needed, aux
Who is covering that case?	NO_INTENT	0.5	not_needed, aux
Who's the officer on the case? 	Prediction_10_Parametric	0.2	prep, tell, det
Who is assigned to the case?	NO_INTENT	1.0	prep, not_needed, det, aux, INCIDENT_TYPE
And which officer responded?	History_10_NonParametric	0.7
Who's on it?	History_10_NonParametric	0.5
Who took the statements?	NO_INTENT	0.8	det, not_needed
Who is the investigator?	NO_INTENT	0.6	risk, det, not_needed, aux
Give me the investigating officer	Prediction_10_Parametric	0.2	tell, det
Who is handling case 12?	NO_INTENT	0.6	not_needed, aux
address of suspect	NO_INTENT	0.7	prep, where, INCIDENT_TYPE
tell me where the suspect lives	Prediction_10_Parametric	0.7	prep, tell, det
What's the address for that suspect?	NO_INTENT	0.3	tell, det, not_needed
Where does the suspect reside?	Prediction_10_Parametric	0.7	where, det, aux
Can I get an address for the suspect? 	History_10_NonParametric	0.3	prep, LOCATION, det
Where does the suspect in the case live? 	Prediction_10_Parametric	0.5	prep, LOCATION, det, aux, where, INCIDENT_TYPE
Find me the suspect's residence. 	Prediction_10_Parametric	0.5	tell, det
Do we have an address for the suspect?	NO_INTENT	0.4	prep, LOCATION, det, not_needed
What's the address for the suspect's residence? 	NO_INTENT	0.3	prep, report, tell, not_needed, det
Pull up the suspect's address.	NO_INTENT	0.6	tell, det, not_needed
Do we have a location for the suspect?	Prediction_10_Parametric	0.5	prep, LOCATION, det
i need to contact the suspect	NO_INTENT	0.7	prep, report, tell, not_needed, det
how can the suspect be reached	Prediction_10_Parametric	0.6	tell, det
I need contact information for the suspect	History_10_NonParametric	0.8	prep, report, LOCATION, tell, det
all contact info of suspect	History_10_NonParametric	0.8	prep, INCIDENT_TYPE
suspect contact details	NO_INTENT	0.3	not_needed
suspect's contact information 	History_10_NonParametric	0.9
What's the suspect's phone number/address?	History_10_NonParametric	0.3	tell, det
Where can I find the suspect?	Prediction_10_Parametric	0.6	prep, det
Do we have contact information for the suspect in the case? 	History_10_NonParametric	0.6	prep, LOCATION, INCIDENT_TYPE, det
Please find me the contact information for the suspect.	History_10_NonParametric	0.7	prep, report, LOCATION, tell, det, INCIDENT_TYPE
How can we reach/get in touch with/get a hold of the suspect? 	Prediction_10_Parametric	0.4	prep, det
I'd like to contact the suspect.	NO_INTENT	0.9	prep, det, not_needed
Get me the suspect's contact information.	History_10_NonParametric	0.6	tell, det
Display contact infomation for the suspect.	Prediction_10_Parametric	0.3	prep, LOCATION, det
How can the suspect be reached? 	Prediction_10_Parametric	0.6	tell, det
What contact information do we have on the suspect? 	History_10_NonParametric	0.4	prep, tell, det
I want to contact the suspect. 	NO_INTENT	0.8	prep, report, tell, not_needed, det
Was the suspect in a gang	Prediction_10_Parametric	0.6	prep, INCIDENT_TYPE, tell, det
Does our suspect have any possible gang connections	NO_INTENT	0.5	not_needed
Was the suspect in a gang?	Prediction_10_Parametric	0.6	prep, INCIDENT_TYPE, tell, det
Do we suspect that the alleged perp was in a gang?	Prediction_10_Parametric	0.4	prep, det
Does our suspect have any possible gang connections?	NO_INTENT	0.5	not_needed
Is there gang involvement suspected? 	NO_INTENT	0.8	not_needed, aux
Is the suspect a gang member? 	Prediction_10_Parametric	0.7	risk, det, aux
Is the suspect in any way connected with a gang?	Prediction_10_Parametric	0.6	risk, prep, det, aux
Is the suspect connected with any gang activity? 	Prediction_10_Parametric	0.6	det, aux
Could the suspect be connected with a gang? 	Prediction_10_Parametric	0.2	prep, tell, det
Any information on possible gang connections for the suspect? 	History_10_NonParametric	0.7	prep, LOCATION, det
Is the suspect known to be a gang member? 	NO_INTENT	0.6	prep, det, not_needed, aux
give me telephone number of case 12 suspect	History_10_NonParametric	0.6	prep, report, INCIDENT_TYPE, tell
give me telephone number of suspect	History_10_NonParametric	0.7	prep, report, INCIDENT_TYPE, tell
and now telephone of case 12 suspect	History_10_NonParametric	0.7	prep, INCIDENT_TYPE
Do we have a telephone number for the suspect? 	History_10_NonParametric	0.3	prep, LOCATION, det
What's the suspect's phone number? 	History_10_NonParametric	0.4	tell, det
How can I call/get in touch with/contact the suspect?	History_10_NonParametric	0.4	prep, det
Give me the phone number for the suspect. 	History_10_NonParametric	0.6	prep, report, LOCATION, tell, det, INCIDENT_TYPE
At what number can the suspect be reached? 	History_10_NonParametric	0.6	prep, det
Can you please find me the suspect's cell?	History_10_NonParametric	0.6	tell, det
Get me the suspect's mobile number. 	History_10_NonParametric	0.6	tell, det
Is there a cell number for the suspect available? 	History_10_NonParametric	0.3	prep, LOCATION, det, aux
Do we know the suspect's phone number? 	History_10_NonParametric	0.5	prep, det
Can we get in touch with the suspect by phone? 	Prediction_10_Parametric	0.3	prep, det
do we have anything about case 12 vehicle	History_10_NonParametric	0.7	prep, INCIDENT_TYPE
what does the car in case 12 look like	NO_INTENT	0.5	tell, det, not_needed
Anything about the car? 	NO_INTENT	0.7	prep, tell, det, not_needed
Information about the car	NO_INTENT	0.7	prep, tell, det, not_needed
What do we have on the car?	NO_INTENT	0.7	prep, tell, det, not_needed
Do we have a description of the car?	NO_INTENT	0.6	prep, det, not_needed
Do we have a car make and model?	NO_INTENT	0.9	prep, det, not_needed
What did the witness say about the car?	NO_INTENT	0.5	prep, tell, det, not_needed
Are there any details on the car?	NO_INTENT	0.8	prep, det, not_needed
And the car?	NO_INTENT	0.9	tell, det, not_needed
What about the vehicle?	Prediction_10_Parametric	0.2	prep, tell, det
Any info on the vehicle?	NO_INTENT	0.4	prep, det, not_needed
How about a vehicle description?	NO_INTENT	0.5	prep, tell, det, not_needed
Do we know anything about the car?	NO_INTENT	0.7	prep, det, not_needed
where does the witness to case 12 live	NO_INTENT	0.8	where, det, not_needed, aux
do you know the address of witness	NO_INTENT	0.7	prep, tell, det, where, INCIDENT_TYPE
do you have the witness's address	NO_INTENT	0.7	prep, tell, det, not_needed
i need the witness's address	NO_INTENT	0.3	tell, det, not_needed
where does the eyewitness live?	Prediction_10_Parametric	0.7	where, det, aux
show me the witness's house	History_10_NonParametric	0.7	tell, det
Where is the witness's residence?	Prediction_10_Parametric	0.7	where, det, aux
Give me the address of the witness.	NO_INTENT	0.5	prep, tell, not_needed, det, where
Where can I find our eyewitness? 	Prediction_10_Parametric	0.2	where, aux
Do we have an address for the eyewitness in this case? 	History_10_NonParametric	0.3	prep, LOCATION, det
What's the address for the eyewitness?	NO_INTENT	0.3	prep, report, LOCATION, tell, det
Can you find me information on the witness' residence?	History_10_NonParametric	0.8	prep, report, tell, det
Where does the witness reside? 	Prediction_10_Parametric	0.7	where, det, aux
What's the witness' address?	NO_INTENT	0.6	tell, det, not_needed
Where can I talk to the witness in person? 	NO_INTENT	0.6	prep, not_needed, det, CALENDARX, INCIDENT_TYPE
What's the address we have for the witness?	NO_INTENT	0.3	prep, LOCATION, tell, not_needed, det
give me contacts of case 12 witness	History_10_NonParametric	0.7	prep, report, INCIDENT_TYPE, tell
do we have contacts of witness to case 12	NO_INTENT	0.6	not_needed
Show witness's contact information 	History_10_NonParametric	1.0	tell
Give me contact information for the witness	History_10_NonParametric	0.8	prep, report, LOCATION, tell, det
Do you have the witness's contact information?	History_10_NonParametric	0.3	prep, tell, det
How can I get in touch with the witness? 	Prediction_10_Parametric	0.3	prep, det
How can the witness be contacted?	Prediction_10_Parametric	0.6	tell, det
Where can I reach the witness? 	Prediction_10_Parametric	0.6	prep, det
What is the witness's phone number/address?	Prediction_10_Parametric	0.7	tell, det, aux
Can I get the contact details for the witness? 	Prediction_10_Parametric	0.6	prep, LOCATION, tell, det
How can we contact the eyewitness?	Prediction_10_Parametric	0.6	prep, det
Find me the contact information for this witness.	History_10_NonParametric	0.7	tell, det
How can I get a hold of the witness?	Prediction_10_Parametric	0.4	prep, det
What do we have on witness	Prediction_10_Parametric	0.2	tell
Who is case 12 witness	NO_INTENT	0.6	not_needed, aux
Describe witness	NO_MATCH	1.0	not_needed
Who is the witness in case 13?	NO_INTENT	0.8	prep, risk, not_needed, det, aux
Show witnesses	History_10_NonParametric	0.9	tell
Do we have anything on the witness in case 12	History_10_NonParametric	0.6	prep, det
Are there any witnesses in case 12	History_10_NonParametric	0.6
Anything on the witness?	Prediction_10_Parametric	0.3	prep, tell, det
Tell me about the witness in that case	History_10_NonParametric	0.7	prep, tell, det
Give me some details on the witness 	History_10_NonParametric	0.4	prep, tell, det
Update me on the witness in case 12	History_10_NonParametric	0.7	prep, tell, det
What about witnesses?	History_10_NonParametric	0.7	INCIDENT_TYPE, tell
Can I get a witness description? 	NO_INTENT	0.3	prep, tell, det, not_needed
Who was the witness in the case?	NO_INTENT	0.6	prep, LOCATION, not_needed, det, INCIDENT_TYPE
Can you give me details on the witness in the case?	History_10_NonParametric	0.7	prep, report, LOCATION, tell, det, INCIDENT_TYPE
Please provide a description of the witness	Prediction_10_Parametric	0.3	prep, tell, det
And the witness?	Prediction_10_Parametric	0.3	tell, det
Any witnesses in the case?	History_10_NonParametric	0.3	prep, LOCATION, det
Was the witness injured	Prediction_10_Parametric	0.6	tell, det
Did the witness sustain any injuries	Prediction_10_Parametric	0.5	tell, det
Was the witness injured?	Prediction_10_Parametric	0.6	tell, det
Was the eyewitness wounded?	Prediction_10_Parametric	0.6	tell, det
Did the witness sustain any injuries?  	Prediction_10_Parametric	0.5	tell, det
Was the witness harmed in any way?	Prediction_10_Parametric	0.6	tell, det
Were there any injuries to the witness? 	NO_INTENT	0.8	prep, INCIDENT_TYPE, det, not_needed
Did the witness escape unharmed? 	Prediction_10_Parametric	0.6	tell, det
Were there any physical injuries sustained by the witness? 	Prediction_10_Parametric	0.6	prep, det
Did the witness have any injuries? 	Prediction_10_Parametric	0.5	tell, det
Was the witness hurt? 	Prediction_10_Parametric	0.6	tell, det
Was the witness harmed during the commission of the crime? 	Prediction_10_Parametric	0.4	prep, INCIDENT_TYPE, tell, det
Did the witness come out of it unharmed? 	Prediction_10_Parametric	0.3	tell, det
navigate to witness	NO_INTENT	1.0	not_needed
Give me the phone number for the witness	History_10_NonParametric	0.6	prep, report, LOCATION, tell, det, INCIDENT_TYPE
How can I call the witness?	Prediction_10_Parametric	0.3	prep, det
How can I call the witness?	Prediction_10_Parametric	0.3	prep, det
Find the witness's number	History_10_NonParametric	0.5	tell, det
Show telephone of the bystander	History_10_NonParametric	0.2	prep, tell, det
What's the number for the eyewitness? 	History_10_NonParametric	0.3	prep, report, LOCATION, tell, det
Where can the witness be reached? 	Prediction_10_Parametric	0.6	where, det, aux
At what number can we reach the eyewitness?	History_10_NonParametric	0.6	prep, det
Get me the phone number for the witness in the case. 	History_10_NonParametric	0.7	prep, report, LOCATION, tell, det, INCIDENT_TYPE
Pull up the phone number for the eyewitness. 	History_10_NonParametric	0.4	prep, report, LOCATION, tell, det, INCIDENT_TYPE
How do I get a hold of the witness in the case? 	Prediction_10_Parametric	0.3	prep, LOCATION, det
What's the witness' phone number? 	History_10_NonParametric	0.5	tell, det
Get me a number where I can contact the witness, please. 	History_10_NonParametric	0.5	prep, tell, det
Do we have a cell number for the eyewitness? 	History_10_NonParametric	0.3	prep, LOCATION, det
show me details on a Mr. Joe Schmo. 	History_10_NonParametric	0.8	prep, report, tell, det
can you tell me whether there is a record on miss callie white? 	History_10_NonParametric	0.6	prep, tell, det, aux, INCIDENT_TYPE
bring up all info for Jonathan Wile	History_10_NonParametric	0.8
what do you have on a Mr. Carl Geiger?	Prediction_10_Parametric	0.3	prep, tell, det
do we have a record on a Ms. Joanna Kyle?	NO_INTENT	0.6	prep, det, not_needed
can i get a background check on Harriet Yelling.	History_10_NonParametric	0.3	prep, tell, det
run a check, please, on a Lola Ferris	NO_INTENT	0.5	prep, tell, det, not_needed
is there any information on a Mr. James Teague?	History_10_NonParametric	0.4	prep, det, aux
can you pull the record for a Greta Finnegan	Prediction_10_Parametric	0.4	risk, prep, tell, det
pull up a Ms. Carlita Gutierrez	NO_INTENT	0.6	tell, det, not_needed
May i please see the record for Jonah Mansfield	Prediction_10_Parametric	0.5	prep, det
check Kim Hilford	NO_MATCH	1.0	not_needed
please search for a Pilar Frost-Winston in the records	Prediction_10_Parametric	0.2	prep, LOCATION, tell, det
Look for Mr. Bin Chook-Lee 	History_10_NonParametric	0.9
find Diem Truong 	NO_MATCH	1.0	not_needed
find Yaroslav Gusevich	NO_MATCH	1.0	not_needed
find Mr. Bin Chook-Lee	NO_MATCH	1.0	not_needed
find Ms. Kelly robinson.	NO_MATCH	1.0	not_needed
Find a Ms. Rosa Deacon	NO_INTENT	0.6	tell, det, not_needed
Give incident details	History_10_NonParametric	0.7
please pull up incident 23456	History_10_NonParametric	0.8
detail on case 234466	History_10_NonParametric	0.8
can you show me incident 23456	History_10_NonParametric	0.7	prep, INCIDENT_TYPE, tell
bring up incident 23456	History_10_NonParametric	0.9
display incident 23456	History_10_NonParametric	0.9
can i please see the details on incident 23456	History_10_NonParametric	0.7	prep, report, tell, det
give me some information on incident 234576	History_10_NonParametric	0.7	tell
show incident 234656	History_10_NonParametric	1.0	INCIDENT_TYPE, tell
incident 233456	History_10_NonParametric	0.9
who are the suspects in incident 23456?	NO_INTENT	0.6	prep, not_needed, det, aux, INCIDENT_TYPE
please pull up the information on case 34567	History_10_NonParametric	0.8	prep, tell, det
i'd like to see the details on incident 23446	NO_INTENT	0.7	prep, det, not_needed
provide the details for incident 77965	History_10_NonParametric	0.6	tell, det
give me the facts on case 98760876	History_10_NonParametric	0.8	prep, INCIDENT_TYPE, tell, det
please pull up the record on case 79657956	History_10_NonParametric	0.7	prep, tell, det
Man of about 30	History_10_NonParametric	0.6	prep, INCIDENT_TYPE, tell
30 year old man	History_10_NonParametric	0.3
Teenage girl	NO_MATCH	1.0	not_needed
Middle-aged woman	NO_MATCH	1.0	not_needed
A lady in years	NO_INTENT	0.3	det, not_needed
Male, nearly 70	NO_MATCH	1.0	tell, not_needed
A man in his seventies	NO_INTENT	0.3	det, not_needed
A woman from 30 to 50	NO_INTENT	0.9	det, not_needed
an elderly male/man/female/woman/gentleman/lady	NO_MATCH	1.0	not_needed
a male/female senior citizen	NO_INTENT	0.5	det, not_needed
pre-teen girl	NO_MATCH	1.0	not_needed
female toddler	NO_MATCH	1.0	not_needed
a school-age girl/boy	NO_INTENT	0.5	det, not_needed
woman of about 30 years of age 	History_10_NonParametric	0.6	prep, INCIDENT_TYPE, tell
old man	Prediction_10_Parametric	0.3
a female senior	NO_INTENT	0.5	det, not_needed
a young lady in her teens	NO_INTENT	0.3	det, not_needed
male, approximately 30 years of age	History_10_NonParametric	0.6	prep, INCIDENT_TYPE, tell
female, over 70 years of age	History_10_NonParametric	0.6	prep, INCIDENT_TYPE, tell
Male teenager	NO_MATCH	1.0	not_needed
White woman	NO_MATCH	1.0	not_needed
Indian girl	NO_MATCH	1.0	not_needed
Black guy	NO_MATCH	1.0	not_needed
Caucasian woman	NO_MATCH	1.0	not_needed
Hispanic male/female/man/woman/lady/gentleman	NO_MATCH	1.0	not_needed
Arab male	NO_MATCH	1.0	not_needed
African-American male	NO_MATCH	1.0	not_needed
Caribbean male	NO_MATCH	1.0	not_needed
Asian male	NO_MATCH	1.0	not_needed
East Asian male	NO_MATCH	1.0	not_needed
South Asian male	NO_MATCH	1.0	not_needed
Native American male	NO_MATCH	1.0	not_needed
African male	NO_MATCH	1.0	not_needed
Latino male / Latina female	NO_MATCH	1.0	not_needed
Male Pacific Islander 	NO_MATCH	1.0	not_needed
American Indian male	NO_MATCH	1.0	not_needed
Middle-Eastern male	NO_MATCH	1.0	not_needed
Male person of color 	History_10_NonParametric	0.6	prep, INCIDENT_TYPE
Native Hawaiian/Alaskan male	NO_MATCH	1.0	not_needed
Male, Hispanic	NO_MATCH	1.0	tell
Black woman in her thirties	History_10_NonParametric	0.6
White man of about 30	History_10_NonParametric	0.6	prep
Native hawaiian, male, 30 years of age	History_10_NonParametric	0.6	prep, INCIDENT_TYPE
Caucasian woman, between 30 and 60	History_10_NonParametric	0.6
Asian boy	NO_MATCH	1.0	not_needed
Woman in mid-thirties, indian	History_10_NonParametric	0.6
Man in mid-to-late seventies	History_10_NonParametric	0.6
Woman in her forties, black	History_10_NonParametric	0.6
African American female, approximately 50 years of age	History_10_NonParametric	0.6	prep, INCIDENT_TYPE
Female, South Asian, over 55 years of age	History_10_NonParametric	0.6	prep, INCIDENT_TYPE, tell
African American senior citizen, female	NO_MATCH	1.0	not_needed
Middle aged Hispanic male	NO_MATCH	1.0	not_needed
25 year old female, caucasian	History_10_NonParametric	0.3
African American teen, male	NO_MATCH	1.0	not_needed
Caucasian woman, 20 to 30 years of age	NO_INTENT	0.6	prep, INCIDENT_TYPE, not_needed
30-year-old white male	NO_MATCH	1.0	not_needed
woman, 100 pounds	NO_MATCH	1.0	tell, not_needed
male 170 pounds	NO_MATCH	1.0	not_needed
man, weighing about 170 pounds	History_10_NonParametric	0.6	tell
man, weight from 150 to 200 pounds	NO_INTENT	1.0	tell, not_needed
slim woman	NO_MATCH	1.0	not_needed
overweight man	NO_MATCH	1.0	not_needed
200-pound female	NO_MATCH	1.0	not_needed
heavyset male	NO_MATCH	1.0	not_needed
obese man	NO_MATCH	1.0	not_needed
thin woman	NO_MATCH	1.0	not_needed
skinny gentleman	NO_MATCH	1.0	not_needed
muscular male	NO_MATCH	1.0	not_needed
woman, weight  over 200 pounds	NO_MATCH	1.0	tell, not_needed
underweight Hispanic female	NO_MATCH	1.0	not_needed
black man, weight 150 pounds	NO_MATCH	1.0	not_needed
white girl, 100 pounds	NO_MATCH	1.0	not_needed
Hispanic female, over 200 pounds	NO_MATCH	1.0	not_needed
Heavyset Asian male	NO_MATCH	1.0	not_needed
extremely thin white female	NO_MATCH	1.0	not_needed
overweight black female	NO_MATCH	1.0	not_needed
Male, African American, heavyset	NO_MATCH	1.0	tell, not_needed
Woman weighing about 150 pounds, Latina	History_10_NonParametric	0.6	CALENDARX
Overweight male, of Middle-Eastern decent	History_10_NonParametric	0.6	prep
Asian female, extremely thin	NO_MATCH	1.0	not_needed
woman, 1 meter 70 cm tall	Prediction_10_Parametric	0.2	tell
the man is 6 feet 4 inches tall	Prediction_10_Parametric	0.7	det, aux
male, height from 6 feet 2 inches to 7 feet 3 inches	NO_INTENT	0.9	tell, not_needed
male 173 cm	NO_MATCH	1.0	not_needed
a tall woman	NO_INTENT	0.5	det, not_needed
middle height man	NO_MATCH	1.0	not_needed
male, about six foot four	History_10_NonParametric	0.6	tell
short female	NO_MATCH	1.0	not_needed
extremely tall man	NO_MATCH	1.0	not_needed
a woman, about five feet seven inches 	Prediction_10_Parametric	0.3	CALENDARX, det
a girl about 60 inches tall	NO_INTENT	0.3	det, not_needed
a male of below/above average height	NO_INTENT	0.5	det, not_needed
a girl in her twenties about 5 feet 3 inches	History_10_NonParametric	0.3	det
a woman about 40 height 5 feet 2 inches	NO_INTENT	0.3	det, not_needed
female, late 30s, about 6 feet tall	Prediction_10_Parametric	0.3	tell
a middle aged man, over 6 feet/foot tall	NO_INTENT	0.6	det, not_needed
Male, about 5 foot 6, approximately 50 years old	Prediction_10_Parametric	0.5	tell
Tall, middle-aged female. 	NO_MATCH	1.0	tell, not_needed
Very short male, possibly in his late 30s	History_10_NonParametric	0.5
Elderly, short  woman	NO_MATCH	1.0	tell, not_needed
Police have blamed the robbery on the IRA which has repeatedly denied any connection to the theft	NO_INTENT	1.0	prep, LOCATION, not_needed, det, aux, INCIDENT_TYPE
The Northern Bank heist is one of the largest in Europesince the theft of more than US$65 million from a London bank in 1987	NO_INTENT	1.0	prep, LOCATION, not_needed, det, aux, CALENDARX, INCIDENT_TYPE
The sheer numbers of the cars and their lack of theft deterrent systems make them thieves ' preferred choic	NO_INTENT	1.0	prep, INCIDENT_TYPE, det, not_needed
According to the reports, Secret Service agents guarding Miss Bush failed to notice the thef	NO_INTENT	1.0	prep, report, not_needed, det, INCIDENT_TYPE
A Bush administration official confirmed that " a theft incident " involving Barbara Bush had occurred, butdeclined de	NO_INTENT	1.0	report, INCIDENT_TYPE, not_needed, aux
Mazhari, who is a sculptor, was charged with the unrelated theft of $100,000 worth of paintings last year. 	NO_INTENT	0.8	prep, not_needed, det, aux, CALENDARX, INCIDENT_TYPE
The crying woman told a constable the plant theft was the fourth from her property in four years. 	Prediction_10_Parametric	0.6	prep, CALENDARX, det
Sergeant Mal Lochrie said that the officer found it hard to stop smiling as the woman gave details of the theft over the phone.	NO_INTENT	0.8	prep, INCIDENT_TYPE, det, not_needed
The man had been in custody for a month on charges of theft from the Royal Library in Stockholm.	Prediction_10_Parametric	0.4	prep, INCIDENT_TYPE, det
The increase in security cameras being used in schools is an attempt to protect valuable schooling equipment from theft and damage, in particular computers incomputer rooms. 	NO_INTENT	0.9	prep, det, not_needed, aux
The FBI listed the theft of the painting as of one of the world 's top ten art crimes inrecent years	NO_INTENT	0.7	prep, INCIDENT_TYPE, det, not_needed
Gruber has been charged with theft before. 	History_10_NonParametric	0.5
s organization based in Washington, D. D. C., calling Logo " another example of an assault on children 's innocence, a means of legitimizing a homosexual lifestyle,mainstreaming homosexuality in a positive and	NO_INTENT	0.3	prep, det, not_needed
He faces charges of attempted homicide, aggravated assault , burglary and criminal mischief. 	History_10_NonParametric	0.7	prep
Atkinson had been charged with kidnap and assault in a separate case involving a Polishwoman.	History_10_NonParametric	0.4	prep, det
An 11-year-old girl faces serious assault charges in California after casting a stone at a group ofboys who were throwing water balloons at her.	NO_INTENT	0.9	prep, det, not_needed
We determined a felony assault had taken place and the officers took theactions that were necessary.	NO_INTENT	0.4	prep, det, not_needed
He is capable of sexual consent and that therefore any sexual contact is automatically deemed in law to be a sex assault , " said OutRage! 's Peter Tatchell. 	NO_INTENT	0.9	prep, tell, not_needed, det, aux
They proceeded to throw grenades and fire their assault weapons. 	NO_INTENT	0.7	not_needed
Officers in full body armour, helmets and gas masks and armed with shotguns and assault rifles were seen moving in. 	History_10_NonParametric	0.6
The force, estimated to be up to a hundred men, overpowered Arafat 's numerous bodyguards, using assault rifles and grenades, before directly assaulting the house.	NO_INTENT	0.9	prep, det, not_needed
ISI were also seen guarding a gated community, and were wearing full military gear including bulletproof vests and M16 assault rifles.	NO_INTENT	0.5	prep, det, not_needed
The goal of this is to see trends in crime and locations.	NO_INTENT	0.8	prep, not_needed, det, aux, INCIDENT_TYPE
The strength of the effect of BID on robbery crimes varied by location.	Prediction_10_Parametric	0.3	prep, det
In emergency circumstances to report a crime; the location of the crime or victims; or the identity, description or location of the person who committedthe crime.	NO_INTENT	0.8	prep, where, det, not_needed
Africa BOPNet crime Google location South Africa Street ViewPosted by Scott Smith Comments	History_10_NonParametric	0.4
Much crime is gang or drug related, and usually occurs in areas that are of little interest to visitors. 	NO_INTENT	0.8	not_needed, aux
First and foremost, identify the high crime districts and avoid them. Speak softly. Dress to blend in.	NO_INTENT	0.7	prep, det, not_needed
While there is no definitive analysis of the New York crime decline to date, most observers believe that the interplay of a number of variables wasresponsible.	NO_INTENT	0.8	prep, risk, not_needed, det, aux
 Now consider the increased senseless violence at our schools and unchecked crime on our streets.	History_10_NonParametric	0.3	tell, det
 Cops Seize Photographer 's Film ... for the crime of street photography ( hat tip: BoingBoing ). 	History_10_NonParametric	0.3	prep, INCIDENT_TYPE, det
Research consistently finds that adverse social conditions are correlated with problem behaviors ( street crime, street gangs, truancy, drop outrates, teen pregnancy, etc. ).	History_10_NonParametric	0.2
For example, Maritimers are as prone as other Canadians to believe that crime in our streets is getting worse. 	NO_INTENT	0.8	not_needed, aux
The ban also had the supportof local businesses, who wanted an end to the thefts, assaults, shoplifting and other street crime on Rotorua streets. 	NO_INTENT	0.9	prep, det, not_needed
They did -- and they repealedthat prohibition after a 15-year national nightmare that included a nationwide rise of organized crime, street violence and ... drinking! 	NO_INTENT	0.5	prep, det, not_needed
Crime was an issue in the area.	Prediction_10_Parametric	0.6	prep, LOCATION, det
 How long will we see people murdered in the street for making fun ofor disagreeing with Islam as in the Netherlands recently?	Prediction_10_Parametric	0.5	prep, det
An American named Michael Brewer, who runs a home for " street kids and runaway 'restavek ' slave children " says carloads of men " who areactually members of the now disbanded military, have began patrolling the streets of Port-au-Prince and are indiscriminately murdering street children for no reason otherthan sport. 	NO_INTENT	0.9	prep, INCIDENT_TYPE, det, not_needed
Count Dracula Beloved war-hero, aristocrat and former cabinet minister Count Vlad Dracula, Hammer of the Turks and Hero of Wallachiawas brutally murdered yesterday by a ruthless gang of accountants and lawyers from England. In his youth, Count Dracula fought to keep his country free fromencroachment by the Ottoman Empire.	NO_INTENT	0.8	prep, det, not_needed
Attorney General Gord Mackintosh struck an independent inquiry into theJames Driskell murder case yesterday amid mounting allegations police and prosecutors failed to disclose evidence that would have cast doubt on the conviction.	NO_INTENT	0.8	prep, det, not_needed
The police chief actually suspected someone else of the murder.Yesterday, the New Brunswick government re-opened the case, finally deciding to examine exhibits seized from the crime scene that somehow have gone untested untilnow. 	NO_INTENT	0.9	prep, report, not_needed, det, CALENDARX, INCIDENT_TYPE
Murder evidence ignored BARBARA BROWN, Justice Reporter The Hamilton Spectator, June 17, 2000 	Prediction_10_Parametric	0.7	prep, CALENDARX, det
s conviction: Report suggests Driskell was a victim of deal-making By KIRK MAKIN AND GRAEME SMITH, Nov. 25, 2003 Gaping holes appeared in a 12-year-oldManitoba murder conviction yesterday after the release of a long-suppressed police report suggesting a key underworld witness was told he would not be charged in anarson prosecution in return for his	NO_INTENT	0.5	prep, risk, tell, not_needed, det, CALENDARX
Prosecutorswithdrew a second-degree murder charge yesterday against Chris McCullough, who spent nearly nine years in prison for the slaying of Tapleytown School teacherBeverley Perrin.	NO_INTENT	0.5	prep, tell, det, not_needed
 Crime in Britain has more than doubled since 1979.	NO_INTENT	0.2	not_needed
A Washington survey, for example, showed that 38 per cent of those asked revealed that they had been a victim of a serious crime within thelast year, compared to the 10 per cent revealed by police statistics. 	NO_INTENT	0.7	prep, det, not_needed
More than 1.5 million carcrimes were committed last year, one in five by people under 21, a survey found. 	NO_INTENT	0.8	CALENDARX, det, not_needed
The revelation comes as an oil industry survey claims 84 per cent of forecourts were hitby crime last year . 	History_10_NonParametric	0.4	prep, CALENDARX, det
The latest security report says installing cameras has finally led to a fall in car theft, but overall hospital crime rose12.5% last year. 	NO_INTENT	0.8	prep, CALENDARX, det, not_needed
for the police, in some parts of the region car related crimes have reached epidemic porportions, in the Thames Valley region for instance, there were 40,000 car- relatedcrimes last year . The police want tougher action taken against offenders: He says that all to often it 's the same people committing the crimes, theyaalso commit more whileon	NO_INTENT	0.9	prep, not_needed, det, CALENDARX, INCIDENT_TYPE
The force, which covers Oxfordshire, Buckinghamshire and Berkshire solved just twenty one point seven percent ofreported crimes last year. 	NO_INTENT	0.6	CALENDARX, det, not_needed
He had served ten years in jail in the Republic for armed robbery.	Prediction_10_Parametric	0.5	prep, det
The hut at North Park, Darlington,was destroyed in an arson attack last year.	History_10_NonParametric	0.4	CALENDARX, det
The whole questionof what constitutes the rightful ownership of great international works of art is a minefield which, except in cases of outright and proven theft in very recent times, is bestleft undisturbed.	Prediction_10_Parametric	0.4	prep, INCIDENT_TYPE, det, aux
Maxine Carr had nothing to do with the Soham murders.	NO_INTENT	0.8	prep, det, not_needed
She had the perfect alibi which distanced her from one of the most terrible crimes of recent decades	NO_INTENT	0.6	prep, tell, det, not_needed
Without A Trace 10pm, C4 Undoubtedly one ofthe most consistently satisfying crime shows of recent years	NO_INTENT	0.7	prep, CALENDARX, tell, not_needed
The island was one of the more peaceful in the West Indies but had been plagued by drugs and violent crime in recent years.	NO_INTENT	0.8	prep, det, not_needed
Tom Cruise has a tough time in Minority Report, where future crime ispredicte	NO_INTENT	1.0	prep, INCIDENT_TYPE, not_needed, aux
Cruise is a drug-addicted cop in a future where murder is predicted before it is committed	NO_INTENT	1.0	prep, risk, not_needed, aux, where, INCIDENT_TYPE
However, the impact of thoseparameters on the accuracy of crime prediction has not been evaluated yet.	NO_INTENT	1.0	prep, risk, not_needed, det, aux, INCIDENT_TYPE
In essence, hotspot mapping is used as a basic form of crime predictio	NO_INTENT	1.0	prep, risk, not_needed, aux, INCIDENT_TYPE
Edward Davey MP acknowledged that his nightmarishcrime predictions were coming true	NO_INTENT	1.0	risk, not_needed, aux
